0 0 0 0 0 0 0 0 0 0 0
0 0 0 0 0 0 0 0 0 0 0
0 0 0 0 0 0 0 0 0 0 0
0 0 0 0 0 0 0 0 4 3 2
0 0 0 0 1 0 0 0 7 6 5
0 0 0 0 0 0 0 3 0 9 8
0 0 0 0 0 0 3 6 0 0 0
4 3 3 3 3 3 3 3 3 3 2
7 6 6 6 6 6 6 6 6 6 5
9 9 9 9 9 9 9 9 9 9 0