0 0 0 0 0 0 0 0 0 0 0
0 0 0 0 0 0 0 0 0 0 0
0 0 0 0 0 0 0 0 0 0 0
0 0 0 0 0 0 0 0 2 3 4
0 0 0 0 1 0 0 0 5 6 7
0 0 0 0 0 0 0 0 8 9 0
0 0 0 0 0 0 0 0 0 0 0
2 3 3 3 3 3 3 3 3 3 4
5 6 6 6 6 6 6 6 6 6 7
9 9 9 9 9 9 9 9 9 9 0