0 0 0 0 0 0 0 0 0 0 0 0 0 0 0 0 0 0 0 0 0
0 0 0 0 0 0 0 0 0 3 1 0 0 0 0 0 0 0 0 0 0
0 0 0 0 0 0 0 0 0 6 4 0 0 0 0 0 0 0 0 0 0
0 0 0 0 0 0 0 0 0 6 4 0 0 0 0 0 0 0 0 0 0
0 0 0 0 0 0 0 0 0 9 7 0 0 0 0 0 0 0 0 0 0
0 0 0 p 0 0 0 0 0 0 0 0 0 0 0 0 0 0 0 0 0
0 0 0 0 0 0 0 0 0 0 0 0 0 0 0 0 0 0 0 0 0
3 2 2 2 2 2 2 2 2 2 1 0 0 3 2 2 1 0 0 0 0
6 5 5 5 5 5 5 5 5 5 4 2 2 6 5 5 4 0 0 0 0
9 8 8 8 8 8 8 8 8 8 7 8 8 9 8 8 7 0 0 0 0