0 0 0 0 0 0 0 0 0 0 0
0 0 0 0 0 0 0 0 3 2 1
0 0 0 0 0 0 0 0 6 5 4
0 0 0 0 0 0 0 0 9 8 7
0 0 0 0 0 0 0 0 0 0 0
0 0 0 p 0 0 0 0 0 0 0
0 0 0 0 0 0 0 0 0 0 0
3 2 2 2 2 2 2 2 2 2 1
6 5 5 5 5 5 5 5 5 5 4
9 8 8 8 8 8 8 8 8 8 7